ginger	shínsher
ireland	aierland
reinhard	rainjard
zealand	zíland
satellite	sátalait
kind	kaind
pauline	polín
read	réd
site	sait
hedgehog	jéshjag
raiders	reiderz
ernie	erni
maker	meiker
bears	bérz
hayley	jeili
cruise	krúz
beauvais	bouvei
mohammad	moujámed
organization	organazeishan
vedette	vidét
buffer	báfer
johanna	shojána
later	leiter
hyundai	jiándei
herb	erb
nice	nais
nails	neilz
covenant	kóvenant
nightmare	naitmer
slater	sleiter
jürgen	shergen
operation	opereishan
sunderland	sánderland
hands	jándz
royce	rois
alternative	olternativ
nichols	níkolz
artois	artuó
lagrange	lágreinsh
nations	neishanz
sundance	sándans
bone	boun
funky	fánki
hearst	jerst
goebbels	goubelz
revival	rivaival
heritage	jératash
suicide	súasaid
foley	fouli
study	stádi
driver	draiver
jens	shénz
hornets	jórnets
hice	jais
behind	bijaind
mighty	maiti
buster	báster
maynard	meinerd
holt	joult
spice	spais
fever	fíver
melville	mélvil
chronicle	krónikel
falling	fálin
fund	fánd
villeneuve	vílinuv
bulletin	búlitan
lund	lánd
raleigh	róli
siegfried	sígfrid
straight	streit
skate	skeit
moreau	merou
mannheim	mánjaim
eindhoven	aindjouven
help	jélp
beaufort	boufert
rule	rúl
hurley	jerli
associated	asousieitad
pasteur	paster
murdoch	merdok
collage	kalásh
halen	jeilen
sessions	séshanz
danzig	dánzig
spiderman	spaiderman
hubbard	jáberd
tyrone	tairoun
bright	brait
ain't	eint
hi	jai
nike	naiki
being	bíin
yard	iárd
cassette	kasét
pubs	pábz
eyed	aid
jeans	shínz
acer	eiser
file	fail
rules	rúlz
production	prodákshan
cream	krím
dungeons	dánshenz
bluff	bláf
contemporary	kantémpereri
bean	bín
lindsey	líndzi
marianne	merián
keys	kíz
gillespie	gilespi
heinkel	jainkel
dictionary	díkshaneri
peak	pík
type	taip
friday	fraidi
byte	bait
vaughan	vón
buzz	báz
beast	bíst
survey	servei
beauty	biúti
burn	bern
upon	apón
millennium	milénium
bunny	báni
archie	árchi
peach	pích
host	joust
ready	rédi
clare	klér
harmony	jármani
suites	suíts
friend	frénd
hippie	jípi
hagen	jeigen
nights	naits
voyage	voiash
harriet	jériat
foreign	fóren
tails	teilz
rising	raizin
mile	mail
o'neal	ouníl
helmut	jélmat
lightning	laitnin
joker	shouker
revenge	rivénsh
coming	kómin
dictatorial	diktatórial
frame	freim
islands	ailandz
crane	krein
stay	stei
commission	komíshan
smile	smail
hayden	jeiden
rodgers	rósherz
pride	praid
many	méni
lives	lívz
volume	válium
talking	tókin
evening	ívnin
administration	administreishan
culture	kálcher
mcdonald's	makdánaldz
bugs	bágz
suspense	saspéns
spectrum	spéktram
croix	kroi
mcdonnell	makdánal
ascii	áski
danielle	daniél
remember	rimémber
carrie	kéri
sketch	skéch
used	iúzd
technologies	teknóloshiz
jessie	shési
beatrice	bíatres
donkey	dónki
laurie	lóri
clair	klér
spain	spein
mine	main
lonely	lounli
barbie	bárbi
paper	peiper
rubin	rúbin
timberlake	tímberleik
clermont	klérmont
revue	riviú
fairfield	férfild
making	meikin
i'll	ail
giant	shaiant
yokohama	ioukojáma
strike	straik
clear	klír
hurricane	jerakein
audrey	ódri
independence	indipéndans
bridges	bríshez
oracle	órakel
hate	jeit
fontaine	fontein
burning	bernin
pub	páb
engine	énshan
range	reinsh
dreyfus	draifas
brain	brein
hanover	jánouver
joint	shoint
ryder	raider
running	ránin
beaumont	boumont
peggy	pégi
butterfly	báterflai
piece	pís
branch	bránch
messenger	mésensher
prize	praiz
unplugged	anplágd
blanche	blánch
agency	eishansi
half	jáf
henrique	anrík
fayette	feiét
complete	kamplít
hilary	jíleri
pearson	pírson
björn	biórn
Étienne	étien
security	sikiúrati
hole	joul
tyson	taisan
davidson	deividson
rise	raiz
jungle	shángel
playoff	pleiof
pacers	peiserz
fate	feit
saints	seints
stories	stóriz
styles	stailz
tigers	taigerz
tea	tí
vogue	voug
hull	jál
hilbert	jílbert
horace	jóras
livingston	lívinston
picture	píkcher
i've	aiv
silence	sailans
salisbury	sálzberi
exchange	ikscheinsh
strange	streinsh
dodgers	dósherz
gilles	shíl
sunset	sánset
providence	právadans
flight	flait
hastings	jeistinz
interactive	interáktiv
lakes	leiks
nuggets	nágets
desert	dézert
jimi	shími
dayton	deiton
much	mách
julien	shúlian
brady	breidi
hanna	jána
early	erli
subdivide	sabdavaid
friedman	frídman
alzheimer	álzjaimer
hale	jeil
june	shún
rondeau	rondou
every	éveri
search	serch
garage	gerásh
sarsfield	sársfild
inside	insaid
please	plíz
rodney	ródni
pentium	péntiam
monkey	mónki
higgins	jíginz
dijon	díshon
katie	keiti
hat	ját
april	eipral
yamaha	iámaja
creative	krieitiv
smart	smárt
farm	fárm
murder	merder
private	praivat
artie	árti
ham	jám
image	ímash
daisy	deizi
republic	ripáblak
universe	iúnavers
billie	bíli
judy	shúdi
strong	strón
bud	bád
job	shób
parade	pereid
rights	raits
cave	keiv
fight	fait
airport	érport
coach	kouch
change	cheinsh
huntington	jántinton
save	seiv
buchanan	biukánan
tears	térz
laurence	lórans
eagles	ígelz
hubble	jábel
sunny	sáni
blazers	bleizerz
amazing	ameizin
blind	blaind
noise	noiz
believe	bilív
voyager	voiasher
fortune	fórchan
nottingham	nótinjam
midnight	mídnait
giants	shaiants
heinz	jainz
herald	jérald
holiday	jóladei
beyond	biónd
guggenheim	gúgenjaim
dragons	drágonz
stage	steish
bradford	brádferd
serge	sersh
baseball	beisból
also	ólsou
sterling	sterlin
fine	fain
cut	kát
holy	jouli
aviation	eivieishan
fields	fíldz
française	franséz
hold	jould
killer	kíler
deluxe	daláks
caché	kásh
fighting	faitin
evolution	evolúshan
quincy	kuínsi
geoffrey	shéfri
ville	víl
clayton	kleiton
apollo	apólou
eastern	ístern
beaver	bíver
hassan	jasán
jericho	shérikou
giulio	shúliou
bureau	biúrou
diane	daián
copyright	kápirait
duff	dáf
nationale	náshanalei
honey	jóni
durham	deram
fuji	fúshi
chao	chau
stevie	stívi
mclaren	makléran
priest	príst
reading	rédin
bryant	braiant
pope	poup
liam	líam
police	palís
lindsay	líndzi
mainstream	meinstrim
voice	vois
curry	kári
liechtenstein	líktenstain
vichy	víshi
halle	jál
charter	chárter
number	námber
joachim	iouákim
precede	prisíd
animation	anameishan
garfield	gárfild
lights	laits
emerge	imersh
banfield	bánfild
pretty	príti
flair	flér
highland	jailand
hand	jánd
björk	biórk
sahagún	sájagan
advanced	advánst
captain	káptan
casey	keisi
give	gív
motion	moushan
angle	ángel
survivor	servaiver
choice	chois
sinclair	sinklér
claus	klóz
abbey	ábi
hussein	jusein
energy	énershi
small	smól
code	koud
beijing	beishín
comes	kámz
echo	ékou
johnston	shónston
neville	névil
clarence	klérans
bytes	baits
vampire	vámpair
precinct	prísinkt
pain	pein
hendrix	jéndriks
beagle	bígel
services	servasez
middle	mídel
alone	aloun
zombie	zómbi
brighton	braiton
train	trein
hansen	jánsen
broken	brouken
language	lánguash
holding	jouldin
cobain	koubein
jeanne	shín
leigh	lí
studies	stádiz
store	stór
upper	áper
horse	jórs
cochrane	kákran
information	infermeishan
hello	jelou
flying	flaiin
building	bíldin
easy	ízi
michele	mishél
hampton	jámpton
purple	perpel
fitzgerald	fitsshérald
johns	shónz
before	bifór
slayer	sleier
pays	peiz
kay	kei
undertaker	ánderteiker
commodore	kámador
jump	shámp
eye	ai
advance	adváns
spielberg	spílberg
extreme	ekstrím
marine	merín
florence	flórans
peace	pís
suns	sánz
library	laibreri
cry	krai
hammer	jámer
voltaire	voultér
guide	gaid
community	kamiúnati
nassau	náso
savage	sávash
joy	shoi
fear	fír
angels	einshelz
fly	flai
knox	nóks
michaels	maikalz
jeffrey	shéfri
fighters	faiterz
challenger	chálensher
said	séd
chopin	shoupan
barney	bárni
dreams	drímz
alive	alaiv
player	pleier
fletcher	flécher
haven	jeiven
gates	geits
core	kór
hesse	jés
gone	gón
trail	treil
aircraft	érkraft
mgm	émgíém
christine	kristín
england	íngland
fry	frai
challenge	chálansh
snake	sneik
future	fiúcher
design	dizain
saturday	sáterdi
tonight	tonait
bailey	beili
diesel	dísel
justice	shástas
australian	ostreilian
hearts	járts
im	ím
robbie	róbi
some	sám
nature	neicher
gear	gír
enterprise	énterpraiz
gerald	shérald
child	chaild
hindi	jíndi
chrysler	kraisler
board	bórd
today	todei
roses	rouziz
pierce	pírs
ghost	goust
igor	igór
andreu	ándru
revolution	revolúshan
ranger	reinsher
laurent	lórent
hammond	jámond
key	kí
broadcasting	bródkastin
ocean	oushen
beautiful	biútafal
ajax	eishaks
hermes	jermiz
jenny	shéni
main	mein
freddie	frédi
paradise	péradais
palace	pálas
ronnie	róni
richter	ríkter
carnegie	kárnegi
riley	raili
guns	gánz
fischer	físher
rice	rais
alliance	alaiens
hoffman	jófman
rumble	rámbel
cold	kould
playboy	pleiboi
seat	sít
years	iírz
make	meik
sunday	sándei
maiden	meiden
gate	geit
performance	perfórmans
hulk	jálk
maggie	mági
presley	présli
development	divélopment
talk	tók
rain	rein
sugar	shúger
earl	erl
judo	shúdou
caroline	kéralain
fair	fér
cage	keish
trade	treid
zone	zoun
haydn	jaidan
alain	alein
leslie	lésli
late	leit
trance	tráns
müller	máler
airbus	érbas
janet	shánet
zhang	shán
byron	bairan
hal	jál
tiger	taiger
stevens	stívenz
erich	érik
true	trú
pleasant	plézant
adventure	advéncher
richardson	rícherdson
hunt	jánt
julius	shúlias
bird	berd
reynolds	rénoldz
médici	medísi
tracy	treisi
say	sei
holly	jáli
case	keis
aleksandr	alaksánder
name	neim
mirage	merásh
bahamas	bajámaz
porsche	pórshe
mind	maind
harald	járald
canterbury	kánterberi
kingston	kínston
berry	béri
absorber	abzórber
five	faiv
against	agénst
burke	berk
belle	bél
federation	federeishan
ellen	élen
rating	reitin
gore	gór
bradley	brádli
peugeot	piushou
rhode	roud
technology	teknálashi
heat	jít
josef	shousef
surf	serf
jake	sheik
dodge	dásh
bosch	bósh
avenue	ávenu
hero	jírou
henderson	jénderson
oakland	oukland
eyes	aiz
but	bát
year	iír
gays	geiz
eugene	iushín
human	jiúman
eagle	ígel
management	mánashmant
heaven	jéven
happy	jápi
harbor	járber
hannah	jána
money	móni
reagan	reigan
oak	ouk
deutsche	doich
crazy	kreizi
joyce	shois
church	cherch
mode	moud
jet	shét
gun	gán
computer	kompiúter
here	jír
face	feis
gene	shín
take	teik
hardy	járdi
european	iurapían
race	reis
jesse	shési
arcade	arkeid
soccer	sóker
poe	pou
yale	ieil
chase	cheis
remake	rímeik
joey	shoui
clay	klei
harvey	járvi
run	rán
hell	jél
hope	joup
burns	bernz
age	eish
bryan	braian
hughes	jiúz
blake	bleik
beat	bít
days	deiz
hugh	jiú
joel	shoual
butler	bátler
battle	bátel
ace	eis
rogers	rósherz
freud	froid
johan	iouján
holmes	joumz
grace	greis
johannes	shoujánes
berkeley	berkli
pearl	perl
kane	kein
gray	grei
place	pleis
head	jéd
hunter	jánter
reggae	régei
project	próshekt
edge	ésh
marge	mársh
people	pípel
lakers	leikerz
hermann	jerman
research	riserch
spears	spírz
georg	geiorg
raymond	reimond
baker	beiker
hart	járt
harold	jérold
sky	skai
summer	sámer
jay	shei
rachel	reichel
may	mei
chelsea	chélsi
manager	mánasher
mccartney	makártni
herbert	jerbert
playoffs	pleiofs
hardcore	járdkór
play	plei
claude	klód
hudson	jádson
guy	gai
dean	dín
square	skuér
charlotte	shárlat
force	fórs
buffy	báfi
anne	án
more	mór
rangers	reinsherz
kate	keit
plate	pleit
grove	grouv
graham	greiam
dream	drím
heart	járt
orange	óransh
seattle	siátal
cleveland	klívland
great	greit
maryland	méraland
jerry	shéri
baby	beibi
renault	renou
jefferson	shéferson
dead	déd
utah	iúto
oklahoma	ouklajouma
sport	spórt
manhattan	manjátan
are	ár
russel	rásel
harvard	járverd
jason	sheison
channel	chánel
jeff	shéf
cup	káp
ryan	raian
go	gou
hard	járd
apple	ápel
rose	rouz
jan	shán
amateur	ámater
home	joum
road	roud
heavy	jévi
lady	leidi
bay	bei
beatles	bítelz
jacques	shák
johann	ioujan
game	geim
team	tím
up	áp
day	dei
by	bai
beach	bích
taylor	teiler
rugby	rágbi
roger	rósher
blues	blúz
jersey	sherzi
blue	blú
joan	shoun
joe	shou
one	uán
hot	jót
punk	pánk
lake	leik
mark	márk
harry	jéri
jones	shounz
all	ól
saint	seint
ohio	oujaiou
billboard	bílbord
league	líg
national	náshanal
royal	roial
jean	shín
college	kálish
henry	jénri
st	strít
jazz	sház
love	láv
charles	chárlz
single	síngel
michael	maikal
paul	pól
george	shórsh
to	tú
york	iórk
john	shón
poverty	páverti
salmon	sámon
wealthy	uélti
assistant	asístant
differently	dífrentli
finish	fínish
acquisition	akuazíshan
page	peish
manage	mánash
breathe	bríd
regain	rigein
corridor	kórader
soldier	soulsher
enormous	inórmos
transfer	transfer
growth	grout
music	miúzik
judgment	sháshment
presentation	prezenteishan
science	saiens
which	uích
authorize	óteraiz
closest	klousest
discourage	diskerish
floor	flór
import	impórt
partner	pártner
master	máster
budget	báshit
reluctant	riláktant
crash	krásh
space	speis
neat	nít
kingdom	kíndom
seemingly	síminli
tactic	táktik
wise	uaiz
balloon	balún
DNA	díenei
indication	indakeishan
ahead	ajéd
peasant	pézant
butter	báter
reputation	repiateishan
spirit	spírat
evident	évadent
ultimately	áltamatli
large	lársh
promote	pramout
serving	servin
technological	teknolóshikal
write	rait
be	bí
drain	drein
French	frénch
insect	ínsekt
along	alón
personnel	personél
candy	kándi
restriction	ristríkshan
dare	dér
star	stár
existing	igzístin
unless	anlés
height	jait
least	líst
sheep	shíp
testimony	téstamouni
behavioral	bijeivieral
concentrate	kánsantreit
intense	inténs
angry	ángri
pine	pain
mixed	míkst
cast	kást
rid	ríd
stimulus	stímialas
extension	iksténshan
value	váliu
hide	jaid
offense	aféns
lie	lai
question	kuéschan
shut	shát
think	tínk
consecutive	kansékiativ
economy	ikánami
generous	shéneros
investigation	investageishan
appearance	apírans
plenty	plénti
romantic	roumántik
density	dénsati
strip	stríp
famous	feimos
violation	vaialeishan
operator	ópereiter
little	lítel
rank	ránk
sink	sínk
timber	tímber
blood	blód
isolated	aisoleited
arrival	eraival
port	pórt
childhood	chaildjud
detail	diteil
female	fímeil
housing	jauzin
ours	auerz
low	lou
boot	bút
rebel	rébel
conventional	konvénshanal
slope	sloup
emotional	imoushanal
touchdown	tóchdaun
graduation	grashueishan
accident	áksadent
outsider	autsaider
magazine	mágazin
bottom	bótom
recognition	rekogníshan
cooking	kúkin
snap	snáp
enact	inákt
toxic	tóksik
grass	grás
motive	moutiv
preach	prích
supply	saplai
weigh	uei
atmosphere	átmasfir
dinner	díner
fitness	fítnes
ad	ád
panel	pánel
manufacturing	maniafákcherin
brilliant	bríliant
regulation	regialeishan
counseling	kaunselin
something	sámtin
entity	éntati
trap	tráp
guitar	gitár
myth	mít
prevail	priveil
script	skrípt
swallow	suálou
wide	uaid
await	aueit
coalition	koualíshan
disorder	disórder
improvement	imprúvmant
affect	afékt
pat	pát
bullet	búlet
removal	rimúval
crew	krú
specialty	spéshalti
estimated	éstameited
tuck	ták
happen	jápen
neighborhood	neiberjud
known	noun
producer	prodúser
Senate	sénat
tank	tánk
wonderful	uónderfal
come	kám
domain	doumein
forward	fóruerd
influential	influénchal
per	per
mention	ménshan
cabin	kában
residence	rézidans
curtain	kertan
spray	sprei
excellent	ékselent
undermine	ándermain
noon	nún
laundry	lóndri
prosecution	prosekiúshan
severely	sevírli
temple	témpel
yell	iél
competitive	kampétativ
dried	draid
friendship	fréndship
instant	ínstant
photograph	foutograf
million	mílian
carbon	kárbon
reveal	rivíl
status	státas
experience	ikspíriens
upset	apsét
objective	abshéktiv
legislative	léshasleitiv
punch	pánch
shock	shók
theater	tíater
belt	bélt
condemn	kondém
gang	gán
another	anóder
plaintiff	pleintaf
mom	móm
ceiling	sílin
riot	raiat
stove	stouv
fabric	fábrik
him	jím
oil	oil
like	laik
signal	sígnal
threat	trét
bit	bít
consist	konsíst
effective	iféktiv
approve	aprúv
pole	poul
round	raund
depressed	diprést
stuff	stáf
faster	fáster
or	ór
location	loukeishan
rational	ráshanal
ski	skí
electronic	ilektrónik
tobacco	tobákou
globe	gloub
suck	sák
wall	uól
possible	pósabel
Christian	kríschan
fierce	fírs
waste	ueist
assemble	asémbel
circuit	serkat
diary	daieri
accurately	ákieratli
owe	ou
maintenance	meintanans
reduction	redákshan
cord	kórd
society	sasaiati
enforcement	enfórsmant
tragedy	tráshadi
grief	gríf
Ms	míz
pregnancy	prégnansi
scary	skéri
surface	serfas
whatever	uatéver
attraction	atrákshan
climb	klaim
disabled	diseibeld
flee	flí
immediate	imídiet
part	párt
market	márket
brush	brásh
relative	rélativ
court	kórt
soul	soul
equality	ikuálati
trend	trénd
keep	kíp
principle	prínsapel
secretary	sékrateri
sword	sórd
win	uín
bad	bád
distribute	distríbiut
increasing	inkrísin
agenda	ashénda
pay	pei
measure	mésher
bury	béri
reply	riplai
crowd	kraud
spell	spél
event	ivént
twist	tuíst
program	prougram
separation	sepereishan
teacher	tícher
world	uerld
basically	beisikli
commissioner	komíshaner
dot	dót
framework	freimuerk
initiative	iníshativ
period	píriad
meter	míter
camera	kámera
respectively	rispéktivli
dam	dám
stack	sták
excuse	ikskiús
uniform	iúnaform
hearing	jírin
notebook	noutbuk
lead	léd
provide	pravaid
shame	sheim
terrain	terein
your	iór
bee	bí
component	kompounent
drug	drág
fuel	fiúal
insurance	inshúrans
analyst	ánalast
miracle	mírakel
carrier	kárier
stem	stém
exploration	eksplereishan
occasionally	akeishanali
lesson	léson
push	púsh
shot	shót
therapy	térapi
better	béter
confrontation	konfronteishan
gathering	gáderin
into	intú
anywhere	éniuer
certainly	sertanli
rocket	róket
street	strít
faint	feint
historical	jistórikal
onion	ónian
link	línk
railroad	reilroud
similarity	simalérati
ticket	tíket
blanket	blánket
construction	konstrákshan
argument	árgiament
pool	púl
cheese	chíz
ruin	rúan
designer	dizainer
substantial	sabstánchal
ability	abílati
organize	órganaiz
loose	lús
bold	bould
contractor	kóntrakter
slave	sleiv
tongue	tán
good	gúd
suit	sút
moreover	morouver
powder	pauder
salt	sólt
weapon	uépon
associate	asousiet
difficult	dífakalt
fire	faier
across	akrós
breathing	brídin
regard	regárd
corruption	kerápshan
sole	soul
enough	inóf
transform	transfórm
guarantee	gerantí
scientific	saiantífik
survival	servaival
while	uail
automatic	otomátik
closet	klózet
discourse	dískors
importance	impórtans
partnership	pártnership
match	mách
rely	rilai
crawl	król
trouble	tróbel
necessarily	nesasérali
segment	ségment
tag	tág
wish	uísh
ballot	bálot
do	dú
format	fórmat
indicator	índakeiter
aid	eid
peel	píl
medicine	médasan
request	rikuést
spiritual	spírichaual
evil	íval
unable	aneibel
largely	lárshli
promotion	promoushan
session	séshan
writer	raiter
companion	kompánian
frequency	fríkuansi
insert	insert
alongside	alónsaid
perspective	perspéktiv
midst	mídst
result	rizált
dark	dárk
stare	stér
exit	égzit
unlike	anlaik
numerous	números
leather	léder
public	páblik
sheer	shír
testing	téstin
concentration	konsentreishan
during	dúrin
intensity	inténsati
pink	pínk
mixture	míkscher
casualty	káshaualti
ride	raid
deem	dím
stir	ster
extensive	iksténsiv
offensive	afénsiv
questionnaire	kueschanér
shuttle	shátel
thinking	tínkin
consensus	konsénsas
ecosystem	íkousistam
genetic	shenétik
plot	plót
changing	cheinshin
deny	dinai
stroke	strouk
fan	fán
violence	vaielens
live	laiv
rape	reip
either	íder
girl	gerl
isolation	aisoleishan
chill	chíl
Russian	ráshan
detailed	diteild
feminist	fémanist
how	jau
abstract	abstrákt
ourselves	auersélvz
lower	louer
booth	bút
rebuild	ribíld
conversation	konverseishan
slot	slót
emotionally	imoushnali
tough	tóf
accommodate	akámadeit
outstanding	autstándin
bounce	bauns
recognize	rékagnaiz
cool	kúl
sneak	sník
encounter	inkaunter
toy	toi
grateful	greitfal
sauce	sós
support	sapórt
weight	ueit
atop	atóp
clean	klín
dip	díp
adapt	adápt
bring	brín
regulator	régialeiter
counselor	kaunseler
sometime	sámtaim
entrance	éntrans
trash	trásh
nail	neil
jurisdiction	shurasdíkshan
prevent	privént
sculpture	skálpcher
swear	suér
widely	uaidli
awake	aueik
coast	koust
display	displei
folk	fouk
impulse	ímpals
afford	afórd
patch	pách
crime	kraim
ethical	étikal
tune	tún
happily	jápali
neighboring	neiberin
product	pródakt
senator	sénater
tap	táp
wood	uúd
bare	bér
comedy	kámadi
domestic	doméstik
foster	fóster
inform	infórm
aisle	ail
perceive	persív
mentor	méntor
cabinet	kábanet
resident	rézident
spread	spréd
except	iksépt
understand	anderstánd
hazard	jázerd
nor	nór
prosecutor	prósikiuter
sex	séks
temporary	témpereri
yellow	iélou
competitor	kompétater
drift	dríft
from	fróm
instantly	ínstantli
photographer	fotógrafer
card	kárd
revelation	reveleishan
statute	stáchut
experienced	ikspírienst
upstairs	apstérz
obligation	oblageishan
legislator	léshasleiter
punish	pánish
shoe	shú
their	dér
bench	bénch
condition	kondíshan
ear	ír
gap	gáp
internal	internal
answer	ánser
moment	moument
celebrate	sélabreit
rip	ríp
vegetable	véshtabal
himself	jimsélf
ok	okei
likelihood	laiklijud
signature	sígnacher
threaten	tréten
bite	bait
investigator	invéstageiter
consistent	konsístent
effectively	iféktivli
approximately	apróksamatli
route	rút
depression	dipréshan
stumble	stámbel
fat	fát
hook	júk
lock	lók
bloody	bládi
raw	rá
contend	konténd
skill	skíl
electronics	ilektróniks
glory	glóri
sudden	sáden
wander	uánder
as	áz
possibly	pásabli
Christianity	krischiániti
developmental	divelopméntal
fifteen	fiftín
watch	uách
assembly	asémbli
circumstance	serkamstans
dictate	dikteit
filter	fílter
accusation	akiazeishan
own	oun
major	meisher
brake	breik
refer	refer
sock	sók
engage	engeish
tragic	tráshik
grin	grín
pregnant	prégnant
scatter	skáter
surgeon	sershen
wheat	uít
attractive	atráktiv
cling	klín
disagree	disagrí
fleet	flít
immediately	imídiatli
administrative	admínastreitiv
partial	párshal
marketing	márketin
relatively	rélativli
courtroom	kórtrum
sound	saund
equally	íkuali
trial	traial
print	prínt
section	sékshan
symbol	símbal
wind	uaind
badly	bádli
collaboration	kolabereishan
distribution	distrabiúshan
forehead	fórjed
increasingly	inkrísinli
agent	eishent
payment	peiment
measurement	méshermant
report	ripórt
crowded	krauded
spend	spénd
eventually	ivénchauali
two	tú
harm	járm
new	nú
programming	prougramin
sequence	síkuans
teaching	tíchin
worldwide	uerlduaid
basis	beisas
commit	komít
double	dóbel
injure	ínsher
allegation	alegeishan
permanent	permanent
method	métod
camp	kámp
respond	rispónd
damage	dámash
stadium	steidiam
execute	éksakiut
unique	iuník
nothing	nótin
leader	líder
provided	provaided
shape	sheip
yours	iúrz
beef	bíf
drum	drám
intact	intákt
analyze	ánalaiz
carrot	károt
rhetoric	réterik
decade	dekeid
step	stép
utility	iutílati
occupation	okiapeishan
let	lét
put	pút
should	shúd
there	dér
between	bituín
confuse	kanfiúz
gay	gei
apart	apárt
chain	chein
rod	ród
demand	dimánd
strength	strénkt
historically	jistórikali
online	ónlain
lion	laian
similarly	símalerli
tide	taid
gesture	shéscher
blast	blást
Irish	airish
consult	konsált
arise	eraiz
poor	púr
desire	dizaier
substantially	sabstánshali
feather	féder
able	eibel
organized	órganaizd
lose	lúz
bolt	boult
contrast	kóntrast
slavery	sleiveri
else	éls
suitable	sútabel
grain	grein
morning	mórnin
Jew	shú
power	pauer
same	seim
sunlight	sánlait
wear	uér
difficulty	dífakalti
firm	ferm
ice	ais
act	ákt
painful	peinfal
breeze	bríz
regarding	regárdin
cost	kóst
solely	souali
enroll	enroul
transformation	transfermeishan
guard	gárd
musician	miuzíshan
presidency	prézadansi
scientist	saiantist
survive	servaiv
whip	uíp
automatically	otomátikli
cloth	klót
discover	diskóver
flour	flauer
important	impórtant
advantage	advántish
party	párti
remain	rimein
Spanish	spánish
especially	espéshli
troubled	tróbeld
handful	jándful
necessary	nésaseri
kiss	kís
probably	prábabli
seize	síz
tail	teil
with	uíd
ban	bán
colony	kálani
dock	dók
formation	formeishan
indigenous	indíshenos
aide	eid
peer	pír
medium	mídiam
button	báton
require	rikuaier
spit	spít
uncertain	ansertan
nine	nain
last	lást
prompt	prómpt
writing	raitin
company	kámpani
dramatic	dramátik
frequent	fríkuant
already	olrédi
might	mait
canvas	kánvas
darkness	dárknes
start	stárt
exotic	igzótik
unlikely	anlaikli
nurse	ners
leave	lív
publication	pablikeishan
sheet	shít
text	tékst
concept	kónsept
dust	dást
funny	fáni
intent	intént
pioneer	paianír
mobile	moubal
cat	kát
rider	raider
deep	díp
stock	stók
extent	ikstént
van	ván
high	jai
offer	ófer
life	laif
quick	kuík
shy	shai
third	terd
billion	bílian
consent	konsént
genius	shínias
application	aplakeishan
plunge	plánsh
depart	dipárt
fantastic	fantástik
violent	vaialant
opponent	opounent
liver	líver
rapid	rápad
sister	síster
elaborate	ilábrat
time	taim
girlfriend	gerlfrend
issue	íshu
arrow	árou
portion	pórshan
chin	chín
detect	ditékt
fence	féns
however	jauéver
abuse	abiús
out	aut
loyal	loial
border	bórder
recall	ríkol
conversion	konvershan
slow	slou
emphasis	émfasas
tour	túr
accompany	akámpani
oven	óven
magic	máshik
boundary	baunderi
recommend	rekoménd
cooperate	kouápereit
snow	snou
encourage	enkerish
trace	treis
mount	maunt
supporter	sapórter
weird	uírd
attach	atách
diplomat	díplomat
ill	íl
add	ád
pant	pánt
map	máp
British	brítish
regulatory	régialatori
count	kaunt
sometimes	samtaimz
entrepreneur	antreprener
travel	trável
juror	shúrer
prevention	privénshan
sea	sí
sweat	suét
widespread	uaidspréd
award	auórd
coastal	koustal
dispute	dispiút
follow	fólou
in	in
afraid	afreid
patent	pátent
bunch	bánch
specific	spesífik
ethics	étiks
tunnel	tánel
happiness	jápines
neither	níder
Korean	korían
send	sénd
tape	teip
wooden	uúden
barely	bérli
dominant	dómanant
found	faund
perceived	persívd
residential	rezidénchal
custody	kástadi
spring	sprín
exception	iksépshan
understanding	anderstándin
he	jí
norm	nórm
prospect	próspekt
ten	tén
yes	iés
complain	komplein
drill	dríl
front	frónt
instead	instéd
ambassador	ambásader
photography	fatágrafi
care	kér
deadline	dédlain
experiment	ikspérament
urban	erban
observation	obzerveishan
legislature	léshasleicher
punishment	pánishment
shoot	shút
them	dém
bend	bénd
conduct	kondákt
international	internáshanal
anticipate	antísapeit
plane	plein
celebration	selebreishan
definitely	défanatli
straighten	streiten
facilitate	fasílateit
vehicle	víjikel
likely	laikli
significance	sagnífikans
three	trí
bitter	bíter
investment	invéstment
consistently	kansístantli
effectiveness	iféktivnas
policeman	palísman
charm	chárm
routine	rutín
depth	dépt
stupid	stúpad
vitamin	vaitaman
log	lóg
blow	blou
content	kóntent
skilled	skíld
elegant	élegant
toe	tou
glove	gláv
suddenly	sádanli
want	uánt
post	poust
device	divais
fifth	fíft
water	uóter
assert	asert
accuse	akiúz
owner	ouner
majority	mashórati
reference	réferans
corn	kórn
sodium	soudiam
engagement	engeishmant
grip	gríp
mud	mád
preliminary	prilímaneri
scenario	sinériou
surgery	sersheri
wheel	uíl
attribute	átrabiut
clinic	klínik
disappear	disapír
flesh	flésh
immigrant	ímagrant
administrator	admínastreiter
partially	párshali
marketplace	márkatpleis
relax	riláks
cousin	kózan
soup	súp
equation	ikueishan
tribal	traibal
nationwide	neishanuaid
prior	praier
symbolic	simbálik
window	uíndou
bag	bág
district	dístrikt
incredible	inkrédabel
aggression	agréshan
meat	mít
bush	búsh
reportedly	ripórtadli
crucial	krúshal
spending	spéndin
ever	éver
newly	núli
lamp	lámp
progress	prógres
worried	uerid
basket	básket
commitment	komítment
doubt	daut
franchise	fránchaiz
injury	ínsheri
alleged	aléshd
permission	permíshan
metropolitan	metropólatan
campaign	kampein
respondent	rispóndent
damn	dám
staff	stáf
execution	eksekiúshan
unit	iúnat
notice	noutas
leadership	lídership
share	shér
terribly	térabli
yourself	iersélf
beer	bír
composition	kompozíshan
drunk	dránk
full	fúl
integrate	íntagreit
ancestor	ánsester
mirror	mírer
carry	kári
decent	dísent
stereotype	stériataip
utilize	iútalaiz
hers	jerz
occupy	ákiapai
letter	léter
puzzle	pázel
shoulder	shoulder
thereby	dérbai
eat	ít
introduction	introdákshan
apartment	apártment
chair	chér
democracy	dimákrasi
strengthen	strénten
victim	víktam
history	jísteri
only	ounli
lip	líp
raise	reiz
tie	tai
get	gét
iron	aiern
consultant	konsáltant
arm	árm
pop	póp
desk	désk
subtle	sátel
feature	fícher
abortion	abórshan
orientation	orienteishan
loss	lós
bomb	bóm
realistic	rialístik
contribute	kantríbiut
elsewhere	élsuer
too	tú
govern	góvern
sail	seil
suite	suít
tourism	túrizam
grand	gránd
mortality	mortálati
jewelry	shúalri
powerful	pauerfal
sample	sámpel
weather	uéder
association	asousieishan
class	klás
dig	díg
firmly	fermli
icon	aikon
action	ákshan
paint	peint
managing	mánashin
brick	brík
regardless	regárdles
costly	kástli
solid	sólad
ensure	enshúr
transit	tránzit
guess	gés
Muslim	mázlam
president	prézadent
scope	skoup
whisper	uísper
automobile	ótamoubil
clothes	kloudz
discovery	diskáveri
flow	flou
importantly	impórtantli
pass	pás
math	mát
bug	bág
remaining	rimeinin
spare	spér
essay	esei
truck	trák
handle	jándel
necessity	nasésati
kit	kít
problem	próblem
seldom	séldom
withdraw	uiddró
former	fórmer
AIDS	eidz
meet	mít
buy	bai
required	rikuaierd
cure	kiúr
spite	spait
evolve	iválv
uncertainty	ansertanti
nobody	noubadi
proof	prúf
set	sét
teen	tín
written	ríten
beam	bím
comparable	kómperabel
dramatically	dramátikli
frequently	fríkuantli
insight	ínsait
pet	pét
cap	káp
retail	ríteil
starter	stárter
expand	ikspánd
helicopter	jélikopter
nut	nát
lecture	lékcher
publicity	pablísati
shelf	shélf
textbook	tékstbuk
conception	konsépshan
Dutch	dách
fur	fer
intention	inténchan
ankle	ánkel
pipe	paip
catalog	kátalog
ridge	rísh
deeply	dípli
stomach	stómak
vanish	vánish
offering	óferin
lifestyle	laifstail
quickly	kuíkli
sibling	síblin
thirty	terdi
bind	baind
consequence	kánsakuans
genre	shánre
apply	aplai
plus	plás
roof	rúf
department	dipártment
strongly	strónli
fantasy	fántasi
opportunity	apertúnati
rapidly	rápadli
sit	sít
elbow	élbou
timing	taimin
it	ít
vulnerable	válnerabel
art	árt
portrait	pórtrat
Chinese	chainíz
detective	ditéktiv
academic	akadémik
outcome	autkam
loyalty	loialti
boring	bórin
receive	rasív
convert	kónvert
slowly	slouli
emphasize	émfasaiz
humanity	jiumániti
accomplish	akómplish
over	ouver
magnetic	magnétik
bow	bau
recommendation	rekomendeishan
cooperation	kouapereishan
so	sou
encouraging	enkerishin
track	trák
gravity	grávati
mountain	mauntan
precious	préshas
supportive	sapórtiv
welcome	uélkam
attack	aták
clearly	klírli
diplomatic	diplomátik
fix	fíks
illegal	ilígal
added	áded
marble	márbel
broad	bród
rehabilitation	rijabilateishan
counter	kaunter
somewhat	sámuát
entry	éntri
traveler	tráveler
gut	gát
naked	neiked
jury	shúri
previous	prívias
seal	síl
sweater	suéter
widow	uídou
aware	auér
coat	kout
dissolve	dizálv
following	fólouin
incentive	inséntiv
African	áfrakan
path	pát
render	rénder
criteria	kraitíria
specifically	spesífikli
ethnic	étnik
turkey	terki
nerve	nerv
lab	láb
productive	pradáktiv
senior	sínier
target	tárget
word	uerd
barn	bárn
comfort	kómfert
dominate	dámaneit
foundation	faundeishan
percentage	perséntash
merchant	merchant
resign	rizain
custom	kástom
sprinkle	sprínkel
excessive	iksésiv
undertake	ánderteik
normally	nórmali
protect	protékt
sexuality	sekshuálati
tend	ténd
yesterday	iésterdei
complaint	kompleint
drink	drínk
frontier	frontír
instinct	ínstinkt
ambition	ambíshan
phrase	freiz
minimal	mínamal
career	kerír
revenue	révenu
deadly	dédli
steadily	stédali
experimental	iksperiméntal
urge	ersh
legitimate	lashítamat
shooting	shútin
theme	tím
beneath	binít
conference	kánferans
garbage	gárbish
anxiety	anzaiati
planet	plánet
celebrity	salébriti
definition	defaníshan
strain	strein
facility	fasíliti
vendor	vénder
hint	jínt
likewise	laikuaiz
racism	reisizam
significant	sagnífikant
threshold	tréshould
investor	invéster
conspiracy	kanspírasi
efficiency	ifíshansi
Arab	árab
policy	pálasi
chart	chárt
routinely	rutínli
deputy	dépiati
style	stail
hopefully	joupfeli
orbit	órbat
logic	lóshik
reach	rích
contest	kóntest
skin	skín
element	élement
together	togéder
Japanese	shapaníz
sue	sú
war	uór
ash	ásh
Christmas	krísmas
devil	déval
fifty	fífti
wave	ueiv
assess	asés
citizen	sítazen
finally	fainali
hurry	jeri
ownership	ounership
brand	bránd
reflect	reflékt
corner	kórner
trailer	treiler
grocery	grouseri
journal	shernal
premise	prémis
scene	sín
surprise	serpraiz
wheelchair	uílcher
auction	ákshan
clinical	klínakal
disappointed	disapointid
immigration	imagreishan
admire	admair
participant	partísapant
marriage	mérish
release	rilís
source	sórs
equip	ikuíp
tribe	traib
halfway	jáfuei
native	neitiv
kick	kík
priority	praiórati
secular	sékialer
sympathy	símpati
wine	uain
collapse	kaláps
disturb	disterb
foreigner	fórener
incredibly	inkrédabli
aggressive	agrésiv
mechanic	mekánik
business	bíznas
reporter	ripórter
sphere	sfír
typical	típakal
news	núz
land	lánd
progressive	pragrésiv
teammate	tímeit
worry	ueri
basketball	básketbol
committee	komíti
dough	dou
frankly	fránkli
inmate	ínmeit
allegedly	aléshadli
permit	permít
Mexican	méksakan
response	rispáns
dance	dáns
executive	igzékiativ
notion	noushan
leading	lídin
provider	provaider
shared	shérd
terrific	terífik
youth	iút
compound	kómpaund
dry	drai
fully	fúli
integrated	íntegreited
ancient	einchant
miss	mís
cart	kárt
rhythm	rídam
export	éksport
vacation	veikeishan
herself	jersélf
occur	oker
level	lével
qualify	kuálafai
shout	shaut
therefore	dérfor
bias	baias
Congress	kóngres
eating	ítin
gaze	geiz
invade	inveid
chairman	chérman
Democrat	démokrat
stress	strés
fairly	férli
victory	víkteri
hit	jít
onto	óntu
liquid	líkuad
simply	símpli
blend	blénd
ironically	airónikli
armed	ármd
chemical	kémakal
ruling	rúlin
desperate	désprit
suburb	sáberb
hostage	jástish
about	abaut
origin	órashan
lost	lóst
bombing	bómin
reality	riálati
contribution	kontrabiúshan
sleep	slíp
embarrassed	imbérast
tool	túl
government	góverment
poster	pouster
tourist	túrast
grandchild	grándchaild
mortgage	mórgash
Jewish	shúish
practical	práktakal
sanction	sánkshan
weave	uív
assume	asúm
classic	klásik
first	ferst
identical	aidéntikal
active	áktiv
painter	peinter
mandate	mándeit
bride	braid
costume	kastúm
solution	solúshan
enter	énter
transition	tranzíshan
guest	gést
must	mást
juice	shús
presidential	prezadénchal
score	skór
suspect	saspékt
white	uait
autonomy	otánami
clothing	kloudin
discrimination	diskrimaneishan
flower	flauer
impose	impouz
advertising	ádvertaizin
passage	pásash
mathematics	matemátiks
create	krieit
spark	spárk
essence	ésans
neck	nék
kitchen	kíchen
procedure	prasísher
select	selékt
withdrawal	uiddróal
band	bánd
colorful	kólerfal
doctrine	dáktran
formerly	fórmerli
aim	eim
pen	pén
meeting	mítin
buyer	baier
requirement	rikuairmant
curiosity	kiuriásati
split	splít
exact	igzákt
uncle	ánkel
nod	nód
lately	leitli
proper	próper
setting	sétin
teenage	tíneish
wrong	rón
compare	kampér
draw	dró
fresh	frésh
insist	insíst
alter	ólter
migration	maigreishan
capability	keipabílati
retailer	ríteiler
database	deitabeis
starting	stártin
expansion	ikspánshan
unprecedented	anprésidentid
nutrient	nútriant
left	léft
publicly	páblikli
shell	shél
texture	tékscher
belief	bilíf
concern	konsern
duty	dúti
furniture	fernicher
interact	interákt
pistol	pístol
model	módel
catch	kách
ridiculous	ridíkialos
deer	dír
stone	stoun
extraordinary	ekstraórdaneri
variable	vériabal
highlight	jailait
office	ófas
lifetime	laiftaim
quiet	kuaiat
sick	sík
this	dís
biography	baiágrafi
consequently	kánsakuantli
edition	edíshan
gentle	shéntel
appoint	apoint
pocket	póket
chaos	keias
room	rúm
departure	dipárcher
structural	strákcheral
far	fár
virtually	verchuali
oppose	apouz
living	lívin
rare	rér
elder	élder
tiny	taini
Italian	itálian
wage	ueish
article	ártakel
portray	portrei
sack	sák
determination	ditermaneishan
accelerate	aksélereit
outdoor	autdor
luck	lák
born	bórn
receiver	resíver
convey	konvei
empire	émpaier
accomplishment	akómplishment
overall	ouverol
magnitude	mágnatud
bowl	boul
cooperative	kouápereitiv
so-called	soukóld
end	énd
mouse	maus
precise	prisais
saving	seivin
suppose	sapouz
welfare	uélfer
attempt	atémpt
clerk	klerk
direct	derékt
fixed	fíkst
illness	ílnes
addition	adíshan
march	márch
broadcast	bródkast
reinforce	riinfórs
counterpart	kaunterpart
somewhere	sámuer
envelope	énvaloup
tray	trei
just	shást
previously	príviasli
sweep	suíp
wife	uaif
awareness	auérnas
distance	dístans
incident	ínsadent
after	áfter
patience	peishans
burden	berden
rent	rént
critic	krítik
specify	spésafai
turn	tern
nervous	nervos
label	leibel
productivity	proudaktívati
sensation	senseishan
task	tásk
work	uerk
comfortable	kómfertabel
donate	douneit
founder	faunder
infrastructure	infrastrákcher
alarm	alárm
perception	persépshan
mere	mír
resist	rizíst
customer	kástomer
spy	spai
headache	jédeik
north	nórt
law	ló
protection	protékshan
sexually	sékshuali
tendency	téndansi
yet	iét
drinking	drínkin
frown	fraun
institution	institúshan
ambitious	ambíshas
physical	fízikal
minimize	mínamaiz
careful	kérfal
reverse	rivers
deal	díl
steady	stédi
expert	ékspert
us	ás
her	jer
observer	obzerver
purchase	perchas
shop	shóp
themselves	demsélvz
benefit	bénefit
confess	konfés
earn	ern
garden	gárden
interpret	interpret
anxious	ánkshas
planner	pláner
cell	sél
risk	rísk
degree	digrí
fact	fákt
venture	véncher
hip	jíp
old	ould
limb	lím
rack	rák
significantly	signífikantli
thrive	traiv
invisible	invízabel
constant	kónstant
efficient	ifíshant
political	polítakal
row	rou
derive	deraiv
father	fáder
order	órder
logical	lóshikal
react	riákt
context	kóntekst
skip	skíp
elementary	eleméntri
toilet	toilet
goal	goul
jar	shár
suffer	sáfer
warehouse	uérjaus
Asian	eishan
chronic	krónik
devote	divout
sum	sám
way	uei
assessment	asésment
citizenship	sítizenship
die	dai
finance	fanáns
hurt	jert
oxygen	áksashan
brave	breiv
reflection	reflékshan
corporate	kórperat
soft	sóft
engineer	énshanír
gross	grous
multiple	máltapel
journalism	shernalizam
premium	prímiam
scent	sént
surprised	serpraizd
when	uén
audience	ádiens
clip	klíp
disappointment	disapointment
flexibility	fleksabílati
immune	imiún
admission	admíshan
participate	partísapeit
married	mérid
bubble	bábel
relevant	rélevant
cover	kóver
south	saut
equipment	ikuípment
trick	trík
hall	jól
kid	kíd
prison	prízon
secure	sikiúr
symptom	símptam
wing	uín
collar	kóler
disturbing	disterbin
forest	fórest
indeed	indíd
ago	agou
peaceful	písfal
mechanical	mekánikal
businessman	bíznasman
reporting	ripórtin
everybody	évribadi
typically	típikli
newspaper	núzpeiper
landing	lándin
prohibit	proujíbat
serious	sírias
tear	tér
worth	uert
bat	bát
commodity	kamádati
down	daun
fraud	fród
inner	íner
alley	áli
Persian	pershan
can	kán
responsibility	rispansabílati
dancer	dánser
stair	stér
exercise	éksersaiz
United	iunaited
leaf	líf
province	právans
shareholder	shérjoulder
territory	téritori
beg	bég
comprehensive	kamprijénsiv
duck	dák
fun	fán
integration	integreishan
and	and
pig	píg
missile	mísal
cartoon	kartún
rib	ríb
decision	disíshan
expose	ikspouz
vaccine	vaksín
hesitate	jézateit
liability	laiabíliti
quality	kuálati
shove	sháv
these	díz
Bible	baibel
congressional	kongréshanal
invasion	inveishan
apologize	apálashaiz
plea	plí
democratic	demokrátik
stretch	stréch
faith	feit
view	viú
hockey	jóki
open	oupen
list	líst
rally	ráli
simultaneously	saimalteiniasli
bless	blés
irony	airani
army	ármi
chemistry	kémastri
desperately	désperatli
suburban	saberban
fee	fí
hostile	jástal
above	abáv
originally	eríshanali
lot	lót
bond	bónd
realize	ríalaiz
contributor	kontríbiater
sleeve	slív
embrace	embreis
tooth	tút
governor	góverner
pot	pót
employ	emploi
tournament	túrnament
grandfather	grándfader
most	moust
practically	práktakli
sand	sánd
web	uéb
assumption	asámpshan
classical	klásikal
dignity	dígnati
identification	aidentafakeishan
actively	áktivli
painting	peintin
bridge	brísh
regime	rashím
cottage	kátash
solve	sálv
translate	tranzleit
mutter	máter
scramble	skrámbel
suspend	saspénd
who	jú
availability	aveilabílati
cloud	klaud
discuss	diskás
fluid	flúad
impossible	impósabel
advice	advais
passenger	pásensher
matter	máter
build	bíld
remark	rimárk
creation	krieishan
speak	spík
essential	isénshal
truly	trúli
handsome	jánsam
need	níd
knee	ní
proceed	prosíd
selected	selékted
tale	teil
within	uidín
column	kólam
document	dókiament
formula	fórmiala
industry	índastri
penalty	pénalti
melt	mélt
rescue	réskiu
curious	kiúrias
spokesman	spouksman
exactly	igzáktli
uncomfortable	ankómfertabel
haul	jól
properly	práperli
settle	sétel
teenager	tíneisher
bear	bér
comparison	kompérason
drawer	drór
freshman	fréshman
inspection	inspékshan
phase	feiz
mild	maild
capable	keipabel
retain	ritein
date	deit
state	steit
expect	ikspékt
until	antíl
o'clock	oklók
leg	lég
publish	páblish
shelter	shélter
than	dán
concerned	kansernd
dying	daiin
furthermore	ferdermor
interaction	interákshan
anniversary	anaverseri
pit	pít
moderate	máderat
category	kátagori
rifle	raifel
defeat	difít
stop	stóp
variation	verieishan
highly	jaili
officer	ófaser
lift	líft
quietly	kuaiatli
side	said
thoroughly	terouli
biological	baialáshikal
conservation	konserveishan
gentleman	shéntelman
appointment	apointment
chapter	chápter
root	rút
depend	dipénd
structure	strákcher
fare	fér
virtue	verchu
homeland	joumland
opposed	apouzd
rarely	rérli
consumer	konsúmer
situation	sichueishan
elderly	élderli
tip	típ
given	gíven
wagon	uágon
articulate	artíkialeit
pose	pouz
sacred	seikred
determine	daterman
few	fiú
accent	aksént
outer	auter
lucky	láki
borrow	bórou
recent	rísent
convict	kónvikt
fighter	faiter
hundred	jándred
according	akórdin
overcome	ouverkam
recording	rekórdin
coordinate	kouórdanet
soak	souk
endless	éndles
mouth	maut
precisely	prisaisli
supposed	sapouzd
well	uél
attend	aténd
direction	derékshan
flag	flág
illusion	ilúshan
additional	adíshanal
country	kántri
environment	invaironment
treasure	trésher
gym	shím
narrative	nárativ
price	prais
season	sízon
sweet	suít
wild	uaild
away	auei
cocaine	koukein
distant	dístant
food	fúd
include	inklúd
afternoon	afternún
patient	peishant
meal	míl
rental	réntal
critical	krítikal
spectacular	spektákialer
harassment	jerásment
nest	nést
laboratory	lábrotori
profession	proféshan
sense	séns
taste	teist
worker	uerker
barrel	bárel
donation	douneishan
four	fór
ingredient	ingrídiant
album	álbam
perfect	perfékt
merely	mírli
cake	keik
resistance	rizístans
squad	skuád
excited	iksaited
unemployment	animploiment
headline	jédlain
northeast	nortíst
lawmaker	lómeiker
protective	pratéktiv
sexy	séksi
tender	ténder
yield	iíld
completely	komplítli
drive	draiv
frozen	frouzen
institutional	institúshanal
amendment	améndment
physically	fízikali
minimum	mínamam
carefully	kérfeli
review	riviú
dealer	díler
steak	steik
expertise	ekspertíz
obstacle	óbstakel
lemon	lémon
pure	piúr
shopping	shópin
then	dén
confession	konféshan
earnings	erninz
interpretation	interpriteishan
any	éni
planning	plánin
monster	mónster
cemetery	sémateri
risky	ríski
delay	dilei
stranger	streinsher
verdict	verdikt
Olympic	oulímpik
limit	límat
radiation	reidieishan
throat	trout
black	blák
invitation	inviteishan
constantly	kánstantli
effort	éfert
politically	palítikali
descend	disénd
fatigue	fatíg
horizon	jeraizon
ordinary	órdaneri
reaction	riákshan
continent	kóntanent
skirt	skert
elephant	élefant
tolerance	tálerans
goat	gout
suffering	sáferin
warm	uórm
aside	asaid
diabetes	daiabítiz
summary	sámeri
we	uí
asset	áset
city	síti
financial	fanánshal
husband	jázband
achieve	achív
pace	peis
makeup	meikep
bread	bréd
reform	refórm
corporation	korpereishan
soften	sófen
engineering	énshanírin
trainer	treiner
ground	graund
journalist	shernalast
preparation	prepereishan
schedule	skéshul
surprising	serpraizin
whenever	uenéver
clock	klók
disaster	dizáster
flexible	fléksabel
impact	impákt
admit	admít
participation	partisapeishan
marry	méri
reliability	rilaiabílati
coverage	káverash
southeast	sautíst
equity	ékuati
trigger	tríger
naturally	nácherali
kill	kíl
prisoner	prízoner
syndrome	síndroum
winner	uíner
bake	beik
colleague	kálig
diverse	daivers
forever	feréver
agree	agrí
mechanism	mékanizam
represent	reprezént
crush	krásh
everyday	évridei
next	nékst
landmark	lándmark
seriously	síriasli
would	uúd
bath	bát
downtown	dauntaun
innocent	ínosent
persist	persíst
Canadian	kaneidian
responsible	rispónsabel
dancing	dánsin
stake	steik
exhaust	igzóst
unity	iúnati
novel	nóvel
provision	províshan
shark	shárk
begin	bigín
comprise	kampraiz
due	dú
function	fánkshan
integrity	intégrati
pile	pail
missing	mísin
carve	kárv
ribbon	ríbon
deck	dék
exposure	ikspousher
vacuum	vákium
odd	ód
quantity	kuántati
show	shou
they	dei
bicycle	baisikal
connect	konékt
ecological	ikolóshikal
gender	shénder
invent	invént
apology	apálashi
plead	plíd
demographic	demográfik
strict	stríkt
fall	fól
viewer	viúer
opening	oupenin
listen	lísen
ranch	ránch
since	síns
tight	tait
blessing	blésin
Islam	islám
around	eraund
popularity	papialérati
chest	chést
despite	dispait
succeed	saksíd
feed	fíd
abroad	abród
other	óder
lots	lóts
really	ríli
slice	slais
top	tóp
grab	gráb
potato	poteitou
sake	seik
smell	smél
employee	emploii
toward	touórd
grandmother	grándmoder
mostly	moustli
practice	práktas
sandwich	sánduich
wedding	uédin
assure	ashúr
classify	klásafai
fish	físh
identify	aidéntafai
activist	áktavast
pair	pér
manipulate	manípialeit
cotton	kóton
entertainment	enterteinment
translation	tranzleishan
guidance	gaidans
press	prés
scratch	skrách
whoever	juéver
available	aveilabel
discussion	diskáshan
impress	imprés
advise	advaiz
passing	pásin
maximum	máksamam
builder	bílder
remarkable	rimárkabel
speaker	spíker
essentially	isénshali
trunk	tránk
hang	ján
needle	nídel
kneel	níl
process	próses
selection	selékshan
talent	tálent
without	uitaut
bank	bánk
columnist	kólamnast
documentary	dakiaménteri
forth	fórt
inevitably	inévatabli
air	ér
pencil	pénsal
currency	keransi
sponsor	spónser
exam	igzám
uncover	ankóver
have	jáv
nomination	nomaneishan
property	práperti
settlement	sételment
telephone	télafoun
beard	bírd
compel	kompél
drawing	dróin
inspiration	inspereishan
although	oldou
phenomenon	fenómenon
capacity	kapásati
retire	ritair
daughter	dóter
statement	steitmant
expectation	ekspekteishan
unusual	aniúshual
helmet	jélmet
legacy	légasi
publisher	páblisher
shift	shíft
thank	tánk
bell	bél
concerning	konsernin
dynamic	dainámik
announce	anauns
pitch	pích
modern	módern
Catholic	kátlik
right	rait
defend	difénd
storage	stórash
extremely	ekstrímli
variety	veraiati
highway	jaiuei
official	ofíshal
light	lait
sidewalk	saiduok
those	douz
biology	baiálashi
conservative	kanservativ
educate	éshakeit
gently	shéntli
appreciate	apríshieit
poem	pouam
character	kérikter
rope	roup
dependent	dipéndent
struggle	strágel
homeless	joumlas
opposite	ápazat
load	loud
rat	rát
consumption	konsámpshan
six	síks
elect	ilékt
glad	glád
its	íts
waist	ueist
position	pozíshan
fewer	fiúer
hug	jág
accept	aksépt
outfit	autfit
lunch	lánch
recently	rísantli
conviction	konvíkshan
hunger	jánger
account	akaunt
overlook	ouverluk
mail	meil
boy	boi
recover	rikóver
coordinator	kouórdaneiter
soap	soup
endorse	endórs
trading	treidin
greatest	greitest
predator	prédater
scale	skeil
supposedly	sapouzadli
west	uést
attendance	aténdans
directly	deréktli
illustrate	ílastreit
address	ádres
parent	pérent
margin	márshan
reject	rishékt
county	kaunti
song	són
environmental	invaironméntal
treat	trít
habit	jábat
narrow	nérou
justify	shástafai
swell	suél
wilderness	uíldernes
awful	áfal
distinct	distínkt
fool	fúl
including	inklúdin
afterward	áfteruerd
patrol	patroul
mean	mín
repair	ripér
criticism	krítisizam
twelve	tuélv
net	nét
lack	lák
professional	proféshanal
sensitive	sénsativ
tax	táks
working	uerkin
barrier	bárier
command	kománd
fourth	fórt
inherent	injírent
perfectly	perfaktli
merit	mérat
calculate	kálkialeit
resolution	rezolúshan
cute	kiút
excitement	iksaitmant
unexpected	anikspéktid
headquarters	jédkuorterz
northern	nórdern
lawn	lón
protein	proutin
shade	sheid
complex	kómpleks
fruit	frút
instruct	instrákt
physician	fazíshan
minister	mínaster
steal	stíl
explain	iksplein
obtain	obtein
lend	lénd
shore	shór
theological	tialáshikal
confidence	kánfadans
earth	ert
garlic	gárlik
interrupt	interápt
anybody	énibadi
plant	plánt
month	mónt
center	sénter
ritual	ríchual
deliberately	dilíberatli
strategic	stratíshik
factory	fákteri
hire	jaier
limitation	limiteishan
silent	sailent
through	trú
blade	bleid
constitute	kánstatut
architect	árkatekt
politician	polatíshan
cheap	chíp
subject	sabshékt
fault	fólt
hormone	jórmoun
organ	órgan
long	lón
continue	kontíniu
skull	skál
elevator	éleveiter
tolerate	tálereit
God	gód
jaw	shó
sacrifice	sákrafais
sufficient	safíshant
warmth	uórmt
ask	ásk
diagnose	daiognous
salad	sálad
weak	uík
assign	asain
civic	sívik
diet	daiat
find	faind
achievement	achívmant
break	breik
refrigerator	refríshereiter
correct	kerékt
softly	sóftli
training	treinin
group	grúp
journey	sherni
scheme	skím
surprisingly	serpraizinli
where	uér
aunt	ánt
close	klous
disc	dísk
implement	ímplement
adolescent	adolésent
particle	pártakel
buck	bák
reliable	rilaiabal
cow	kau
southern	sódern
equivalent	ikuívalent
trim	trím
hallway	jóluei
privacy	praivasi
see	sí
system	sístam
winter	uínter
collect	kolékt
diversity	diversati
forget	fergét
independent	indipéndent
agreement	agríment
medal	médal
busy	bízi
representation	reprezenteishan
everyone	évriuan
harsh	jársh
landscape	lándskeip
projection	proshékshan
servant	servant
teaspoon	tíspun
wound	uaund
bathroom	bátrum
common	kómon
dozen	dózen
free	frí
innovation	inoveishan
allow	alau
person	person
cancel	kánsel
rest	rést
danger	deinsher
stance	stáns
exhibit	igzíbit
heavily	jévali
now	nau
lean	lín
provoke	pravouk
sharp	shárp
terrorism	térerizam
beginning	bigínin
compromise	kámpramaiz
functional	fánkshanal
intellectual	intalékchual
angel	einshel
pill	píl
mission	míshan
stick	stík
express	iksprés
valid	válad
hey	jei
odds	ódz
liberty	líberti
quarter	kuórter
shower	shauer
thick	tí
bid	bíd
connection	konékshan
economic	ekonómik
passion	páshan
invention	invénshan
apparent	apérent
chamber	cheimber
role	roul
demonstrate	démanstreit
strictly	stríktli
village	vílash
openly	oupanli
listener	lísener
egg	ég
tighten	taiten
gift	gíft
Islamic	izlámik
arrange	ereinsh
population	popialeishan
chew	chú
runner	ráner
dessert	dizert
success	saksés
feedback	fídbak
absence	ábsans
others	óderz
loud	laud
realm	rélm
controversial	kontrovershal
slide	slaid
emergency	imershansi
topic	tópik
potential	poténshal
employer	emploier
towards	touórdz
grandparent	grándperent
mother	móder
practitioner	praktíshaner
weed	uíd
astronomer	astrónomer
classroom	klásrum
dilemma	diléma
fisherman	físherman
identity	aidéntati
activity	aktívati
manner	máner
brief	bríf
register	réshister
couch	kauch
somebody	sómbadi
enthusiasm	intúziazam
transmission	transmíshan
my	mai
pressure	présher
scream	skrím
suspicion	saspíshan
whole	joul
clue	klú
disease	dizíz
impression	impréshan
adviser	advaizer
creativity	krieitívati
establish	istáblish
trust	trást
negative	négativ
knife	naif
processing	prósesin
self	sélf
talented	tálented
witness	uítnes
banker	bánker
combat	kómbat
fortunately	fórchanatli
infant	ínfant
pension	pénshan
member	mémber
researcher	rísercher
current	kerent
spoon	spún
examination	igzamaneishan
under	ánder
nominee	nomaní
latter	láter
proportion	propórshan
seven	séven
telescope	télaskoup
compelling	kompélin
inspire	inspair
altogether	oltogéder
philosophical	filosófikal
military	mílateri
retired	ritaird
station	steishan
expected	ikspékted
shine	shain
thanks	tánks
concert	kónsert
dynamics	dainámiks
gain	gein
interest	íntrast
announcement	anaunsmant
pitcher	pícher
modest	módest
cattle	kátel
defendant	diféndant
various	vérias
hike	jaik
officially	afíshali
lighting	laitin
quit	kuít
though	dou
consider	konsíder
education	eshakeishan
genuine	shéniauen
appreciation	aprishieishan
poet	pouat
characteristic	kerakterístik
depending	dipéndin
student	stúdent
farmer	fármer
homework	joumuerk
opposition	opozíshan
loan	loun
rate	reit
contact	kóntakt
sixth	síkst
election	ilékshan
tired	taierd
glance	gláns
itself	itsélf
wait	ueit
artifact	ártafakt
positive	pázativ
cholesterol	kolésterol
devastating	dévasteitin
fiber	faiber
huge	jiúsh
acceptable	akséptabel
boss	bós
reception	risépshan
convince	kanvíns
diagnosis	daiagnousas
hungry	jángri
accountability	akauntabiliti
overnight	ouvernait
boyfriend	boifrend
recovery	rikóvri
cop	kóp
soar	sór
endure	endiúr
tradition	tradíshan
greatly	greitli
movement	múvmant
predict	pridíkt
scan	skán
Supreme	saprím
western	uéstern
attention	aténshan
click	klík
flame	fleim
adequate	ádakuat
parental	peréntal
broker	brouker
coup	kú
soon	sún
envision	envíshan
treatment	trítment
habitat	jábatat
swim	suím
wildlife	uaildlaif
distinction	distínkshan
foot	fút
income	ínkam
again	agén
pattern	pátern
meaning	mínin
repeat	ripít
criticize	krítisaiz
speculate	spékialeit
evaluate	iváliueit
twentieth	tuéntiat
ladder	láder
professor	proféser
sensitivity	sensitíviti
taxpayer	tákspeier
workout	uerkaut
commander	kománder
donor	douner
fraction	frákshan
inherit	injérat
perform	perfórm
mess	més
calculation	kalkialeishan
resolve	rizálv
cycle	saikal
squeeze	skuíz
exciting	iksaitin
unfair	anfér
heal	jíl
northwest	nortuést
lawsuit	lósut
protest	proutest
shadow	shádou
because	bikóz
complexity	kampléksati
driveway	draivuei
frustrate	frástreit
instruction	instrákshan
amid	amíd
physics	fíziks
ministry	mínastri
dear	dír
steam	stím
explanation	eksplaneishan
useful	iúsfal
obvious	ábvias
length	lénkt
purpose	perpas
short	shórt
theology	tiálashi
beside	bisaid
confident	kónfadent
earthquake	ertkueik
gasoline	gásalin
interval	ínterval
anymore	enimór
plastic	plástik
monthly	mántli
river	ríver
delicate	délakat
strategy	strátashi
faculty	fákalti
his	jíz
on	ón
limited	límated
silk	sílk
throughout	truaut
involve	inválv
constitution	konstatúshan
architecture	árkatekcher
politics	pólatiks
cheat	chít
rub	ráb
description	diskrípshan
submit	sabmít
voluntary	válanteri
horn	jórn
organic	orgánik
long-term	lónterm
boast	boust
reader	ríder
continued	kontíniud
eleven	iléven
toll	toul
sad	sád
warn	uórn
asleep	aslíp
chunk	chánk
salary	sáleri
summit	sámat
weaken	uíken
assignment	asainment
civilian	savílian
differ	dífer
finding	faindin
hypothesis	jaipátasas
acid	ásad
pack	pák
male	meil
breakfast	brékfast
refuge	réfiush
correctly	keréktli
software	sóftuer
English	ínglish
trait	treit
muscle	másel
prescription	preskrípshan
scholar	skóler
surround	seraund
whereas	ueráz
closed	klouzd
discipline	dísaplan
flip	flíp
implementation	implementeishan
adopt	adópt
mask	másk
bucket	báket
relief	rilíf
crack	krák
southwest	sautuést
trip	tríp
near	nír
killing	kílin
seed	síd
table	teibel
wipe	uaip
balance	bálans
collection	kolékshan
forgive	fergív
agricultural	agrakálcheral
peanut	pínat
representative	reprazéntativ
crystal	krístal
spill	spíl
everything	évritin
ugly	ágli
lane	lein
prominent	prómanent
serve	serv
technical	téknikal
wow	uau
battery	báteri
commonly	kámanli
draft	dráft
freedom	frídom
innovative	ínaveitiv
ally	álai
dangerous	deinsheros
stand	stánd
exhibition	eksabíshan
nowhere	nouuer
leap	líp
psychological	saikaláshikal
sharply	shárpli
terrorist	térerist
behalf	bijáf
dumb	dám
intelligence	intélashans
pillow	pílou
missionary	míshaneri
rich	rích
decline	diklain
stiff	stíf
expression	ikspréshan
validity	valídati
quarterback	kuórterbak
shrimp	shrímp
thigh	tai
big	bíg
conscience	kánshans
economically	ekonómikli
generally	shénerali
inventory	invantóri
apparently	apérantli
champion	chámpian
roll	roul
demonstration	demonstreishan
false	fóls
operate	ápereit
literally	líterali
sing	sín
ego	ígou
tightly	taitli
gifted	gífted
blink	blínk
island	ailand
arrangement	ereinshmant
porch	pórch
chicken	chíken
destination	destaneishan
successful	saksésfal
feel	fíl
hour	auer
absolute	ábsalut
otherwise	áderuaiz
book	búk
rear	rír
controversy	kántraversi
slight	slait
emerging	imershin
toss	tós
grade	greid
potentially	paténshali
convinced	kanvínst
smoke	smouk
employment	emploiment
towel	tauel
grant	gránt
praise	preiz
supermarket	súpermarkit
week	uík
at	át
fishing	físhin
ideological	aidialáshikal
actress	áktres
pale	peil
briefly	brífli
regret	regrét
could	kúd
someday	sámdei
entire	intaier
transmit	tranzmít
guideline	gaidlain
myself	maisélf
presumably	prazúmabli
screen	skrín
suspicious	saspíshas
whom	júm
average	áverish
cluster	kláster
dish	dísh
focus	foukas
impressive	imprésiv
advocate	ádvakat
past	pást
maybe	meibi
bulb	bálb
remind	rimaind
creature	krícher
special	spéshal
establishment	istáblishment
truth	trút
negotiate	negoushieit
knock	nók
processor	próseser
sell	sél
wolf	uúlf
banking	bánkin
combination	kombaneishan
infection	infékshan
membership	mémbership
resemble	rizémbel
currently	kerantli
examine	igzámin
undergo	andergou
none	nán
laugh	láf
proposal	propouzal
seventh	sévent
yeah	iá
compensation	kompenseishan
install	instól
aluminum	alúmanam
philosophy	falásafi
milk	mílk
capture	kápcher
retirement	ritaierment
dawn	dón
statistical	statístikal
expedition	ekspedíshan
update	apdeit
legally	lígali
pull	púl
ship	shíp
Thanksgiving	tanksgívin
belly	béli
conclude	kanklúd
each	ích
galaxy	gálaksi
interested	íntrastad
annual	ániual
modify	mádafai
defender	difénder
eyebrow	aibrau
vary	véri
often	ófen
lightly	laitli
quite	kuait
sigh	sai
thought	tót
birth	bert
educational	eshakeishanal
approach	aprouch
poetry	pouatri
characterize	kérakteraiz
depict	dipíkt
fascinating	fásaneitin
honest	ónest
opt	ópt
lobby	lábi
rather	ráder
contain	kontein
size	saiz
electric	iléktrik
tissue	tísiu
glass	glás
jacket	sháket
wake	ueik
possess	pozés
choose	chúz
develop	divélop
fiction	fíkshan
acceptance	akséptans
outline	autlain
lung	lán
both	bout
recession	riséshan
dialogue	daiolog
accounting	akauntin
oversee	ouversi
mainly	meinli
recruit	rekrút
cope	koup
enemy	énami
traditional	tradíshanal
Greek	grík
movie	múvi
join	shoin
prediction	pridíkshan
scandal	skándal
sure	shúr
wet	uét
attitude	átatud
client	klaiant
dirt	dert
flash	flásh
adjust	ashást
parish	párish
bronze	bránz
related	rileitid
couple	kópel
sophisticated	sofístakeitid
epidemic	epadémik
treaty	tríti
nasty	násti
primarily	praimérali
second	sékond
swimming	suímin
will	uíl
back	bák
coffee	kófi
distinctive	distínktiv
football	fútbol
incorporate	inkórpereit
meaningful	míninfal
repeatedly	ripítidli
speculation	spekialeishan
evaluation	ivaliueishan
twenty	tuénti
profile	proufail
sentence	séntans
workplace	uerkpleis
comment	kóment
door	dór
fragile	fráshal
initial	iníshal
alien	eilian
message	mésash
calendar	kálender
resort	rizórt
dad	dád
exclude	iksklúd
unfold	anfould
health	jélt
nose	nouz
lawyer	lóier
protocol	proutokol
shake	sheik
tent	tént
you	iú
become	bikám
compliance	komplaiens
driving	draivin
frustration	frastreishan
instructional	instrákshanal
among	amón
minor	mainer
revolutionary	revalúshaneri
death	dét
steel	stíl
explicit	iksplísat
user	iúzer
obviously	ábviasli
lens	lénz
purse	pers
shortage	shórtash
theoretical	tierétikal
besides	bisaidz
confirm	konferm
ease	íz
intervention	intervénchan
anyone	éniuen
monument	móniument
century	séncheri
delight	dilait
straw	stró
fade	feid
very	véri
Hispanic	jispánik
rage	reish
silly	síli
throw	trou
blame	bleim
involved	inválvd
constitutional	konstatúshanal
poll	poul
check	chék
rubber	ráber
subsequent	sábsekuant
volunteer	volantír
organism	órganizam
longtime	lóntaim
boat	bout
readily	rédali
continuing	kantíniuin
slam	slám
eligible	élashabel
tomato	tomeitou
gold	gould
safe	seif
suggest	sagshést
warning	uórnin
aspect	áspekt
sun	sán
weakness	uíknes
assist	asíst
civilization	sivalizeishan
difference	díferans
acknowledge	aknálish
package	pákash
mall	mól
breast	brést
refugee	réfiushi
correlation	koreleishan
soil	soil
enhance	enjáns
grow	grou
museum	miuzíam
presence	prézans
scholarship	skólership
surrounding	seraundin
wherever	ueréver
author	óter
closely	klousli
disclose	disklouz
float	flout
implication	implakeishan
adoption	adópshan
particularly	partíkialerli
mass	más
craft	kráft
sovereignty	sóvrenti
triumph	traiamf
nearby	nírbai
privately	praivatli
seek	sík
tablespoon	teibelspun
wire	uaier
balanced	bálanst
collective	kaléktiv
divine	divain
fork	fórk
Indian	índian
agriculture	ágrikalcher
medical	médakal
Cuban	kiúban
spin	spín
everywhere	évriuer
uh	á
night	nait
promise	prámas
service	servas
technician	tekníshan
wrap	ráp
communicate	kamiúnakeit
drag	drág
freely	fríli
input	ínput
almost	ólmoust
personality	persanáliti
candidate	kándadeit
restore	ristór
standard	stánderd
exist	igzíst
university	iunaversati
nuclear	núklier
learn	lern
psychologist	saikálashast
she	shí
test	tést
behave	bijeiv
concede	kansíd
dump	dámp
fundamental	fandaméntal
intelligent	intélashent
anger	ánger
pilot	pailot
mistake	misteik
cash	kásh
decorate	dékereit
still	stíl
extend	iksténd
valley	váli
off	óf
license	laisans
queen	kuín
shrink	shrínk
thin	tín
bike	baik
conscious	kónshas
economics	ekonómiks
generate	shénereit
invest	invést
appeal	apíl
pleased	plízd
championship	chámpianship
rolling	roulin
denial	dinaial
striking	straikin
fame	feim
operating	ópereitin
literary	lítereri
singer	síner
eight	eit
tile	tail
block	blók
array	erei
pork	pórk
chief	chíf
destroy	distroi
feeling	fílin
house	jaus
absolutely	absolútli
ought	ót
lovely	lóvli
boom	búm
reason	rízon
convenience	kanvínians
slightly	slaitli
emission	imíshan
totally	toutali
gradually	gráshuali
pound	paund
bother	bóder
recipe	résapi
cook	kúk
smooth	smúd
empty	émpti
tower	tauer
grape	greip
motivate	moutaveit
pray	prei
satisfaction	satasfákshan
supervisor	súpervaizer
weekend	uíkend
athlete	átlit
diminish	dimínish
fist	físt
ideology	aidiálashi
Palestinian	palistínian
regularly	régialerli
council	kaunsal
somehow	sámjau
entirely	intaierli
transport	transpórt
guilt	gílt
mysterious	mistírias
pretend	priténd
screening	skrínin
sustain	sastein
whose	júz
disk	dísk
fog	fóg
improve	imprúv
aesthetic	estétik
bulk	bálk
reminder	rimainder
credibility	kredabíliti
specialist	spéshalast
estate	isteit
try	trai
negotiation	nigoushieishan
know	nou
proclaim	proukleim
seller	séler
woman	uúman
bankruptcy	bánkrapsi
combine	kámbain
dog	dóg
forty	fórti
inflation	infleishan
airline	érlain
memory	mémeri
reservation	rezerveishan
curriculum	keríkialam
spot	spót
example	igzámpel
undergraduate	andergráshauet
nonetheless	nandalés
laughter	láfter
propose	prapouz
several	sévral
tell	tél
compete	kampít
dress	drés
installation	instaleishan
always	ólueiz
phone	foun
mill	míl
car	kár
retreat	ritrít
statistics	statístiks
expense	ikspéns
helpful	jélpfal
object	óbshekt
legend	léshend
pulse	páls
shirt	shert
that	dát
belong	bilón
conclusion	konklúshan
eager	íger
gallery	gáleri
interesting	íntrastin
annually	ániuali
placement	pleismant
rim	rím
defense	diféns
storm	stórm
vast	vást
oh	ou
quote	kuout
sight	sait
thousand	tauzand
birthday	bertdei
considerably	kansíderabli
educator	éshakeiter
appropriate	aproupriet
point	point
charge	chársh
rough	róf
deploy	diploi
studio	stúdiou
fashion	fáshan
visit	vízat
honestly	ánastli
optimistic	optamístik
container	konteiner
electrical	iléktrikal
title	taitel
glimpse	glímps
successfully	saksésfali
walk	uók
artist	ártast
possession	pozéshan
chop	chóp
developer	divéloper
field	fíld
access	ákses
output	autput
machine	mashín
cigarette	sigerét
diamond	daimond
accuracy	ákierasi
overwhelm	ouveruélm
red	réd
copy	kápi
traditionally	tradíshanali
green	grín
Mr	míster
prefer	prefer
scare	skér
surely	shúrli
whale	ueil
attorney	aterni
cliff	klíf
dirty	derti
flat	flát
imagination	imashaneishan
adjustment	ashástment
park	párk
brother	bróder
relation	rileishan
courage	kerash
sorry	sári
episode	épasoud
tree	trí
hair	jér
nation	neishan
primary	praimeri
secondary	sékanderi
swing	suín
willing	uílin
background	bákgraund
cognitive	kágnitiv
distinguish	distínguish
for	fór
increase	inkrís
meantime	míntaim
replace	ripleis
crop	króp
speech	spích
even	ívin
twice	tuais
hardly	járdli
never	néver
profit	prófat
sentiment	séntament
works	uerks
basement	beismant
commercial	komershal
doorway	dóruei
fragment	frágment
initially	iníshali
alike	alaik
performer	perfórmer
call	kól
resource	rísors
daily	deili
stability	stabíliti
exclusive	iksklúsiv
unfortunately	anfórchanatli
healthy	jélti
not	nót
lay	lei
proud	praud
shall	shál
term	term
young	ión
bed	béd
complicated	kómplakeited
drop	dróp
instructor	instrákter
amount	amaunt
pick	pík
minority	mainórati
carpet	kárpet
debris	debrí
steep	stíp
explode	iksploud
occasion	okeishan
pursue	persú
shortly	shórtli
theory	tíri
best	bést
conflict	kónflikt
easily	ízali
interview	ínterviu
anything	énitin
platform	plátform
mood	múd
ceremony	séramouni
deliver	dilíver
streak	strík
fail	feil
vessel	vésel
historian	jistórian
silver	sílver
thumb	tám
involvement	inválvmant
constraint	konstreint
pollution	polúshan
cheek	chík
deserve	dizerv
subsidy	sábsidi
favorite	feiverit
voter	vouter
horrible	jórabel
abandon	abándon
look	lúk
body	bádi
continuous	kantíniuas
slap	sláp
eliminate	ilímaneit
tomorrow	tomórou
golden	goulden
safely	seifli
suggestion	sagshéschan
warrior	uórier
ass	ás
pour	pór
wealth	uélt
assistance	asístans
claim	kleim
different	díferent
finger	fínger
acquire	akuaier
pad	pád
man	mán
breath	brét
refuse	rafiúz
correspondent	korespóndent
enjoy	enshoi
transaction	tranzákshan
growing	grouin
mushroom	máshrum
judge	shásh
present	prézent
school	skúl
surveillance	serveilans
whether	uéder
authority	atórati
closer	klouser
discount	diskaunt
flood	flód
imply	implai
adult	adált
partly	pártli
massive	másiv
buddy	bádi
religious	rilíshas
troop	trúp
nearly	nírli
king	kín
privilege	prívlash
seem	sím
tackle	tákel
wisdom	uízdom
ball	ból
collector	kolékter
divorce	divórs
form	fórm
indicate	índakeit
ah	á
medication	medakeishan
butt	bát
Republican	ripáblikan
cue	kiú
spine	spain
evidence	évadans
ultimate	áltamat
harvest	járvest
lap	láp
promising	prómasin
technique	tekník
wrist	ríst
communication	komiunakeishan
freeze	fríz
inquiry	inkuairi
personally	persanali
middle-class	mídelklás
candle	kándel
restrict	ristríkt
standing	stándin
existence	egzístans
unknown	announ
heel	jíl
learning	lernin
psychology	saikálashi
shed	shéd
testify	téstafai
behavior	bijeivier
conceive	kansív
funding	fándin
intend	inténd
pin	pín
mix	míks
decrease	dikrís
stimulate	stímialeit
extended	iksténded
hidden	jíden
offender	ofénder
lid	líd
quest	kuést
shrug	shrág
thing	tín
bill	bíl
consciousness	kónshasnes
economist	ikónomist
generation	shenereishan
investigate	invéstageit
appear	apír
pleasure	plésher
Roman	rouman
dense	déns
string	strín
family	fámali
violate	vaialeit
literature	líteracher
eighth	eitt
till	tíl
blond	blónd
isolate	aisaleit
arrest	erést
rush	rásh
destruction	distrákshan
fellow	félou
household	jausjould
absorb	abzórb
our	auer
lover	lóver
boost	búst
reasonable	rízonabel
convention	konvénshan
slip	slíp
emotion	imoushan
touch	tóch
graduate	gráshauet
mad	mád
bottle	bótel
recipient	rasípiant
cookie	kúki
enable	eneibel
town	taun
grasp	grásp
motivation	moutaveishan
prayer	prér
satisfy	sátasfai
supplier	saplaier
weekly	uíkli
athletic	atlétik
dining	dainin
fit	fít
if	íf
actually	ákchuali
palm	pám
manufacturer	maniafákcherer
regulate	régialeit
counsel	kaunsel
someone	sámuan
entitle	entaitel
transportation	transperteishan
guilty	gílti
mystery	místeri
junior	shúnier
screw	skrú
sustainable	sasteinabel
why	uai
avoid	avoid
coal	koul
dismiss	dismís
fold	fould
improved	imprúvd
affair	afér
pastor	páster
bull	búl
remote	rimout
credit	krédat
specialize	spéshalaiz
estimate	éstamat
tube	túb
neighbor	neiber
knowledge	nálash
seminar	sémanar
tall	tól
wonder	uónder
bar	bár
combined	kambaind
doll	dól
forum	fóram
influence	ínfluens
airplane	érplein
pepper	péper
mentally	méntali
cab	káb
reserve	rizerv
spouse	spaus
exceed	iksíd
underlying	anderlaiin
nonprofit	nonprófat
launch	lónch
proposed	prapouzd
severe	savír
temperature	témpracher
competition	kompetíshan
friendly	fréndli
instance	ínstans
photo	foutou
carbohydrate	karboujaidreit
return	ritern
statue	stáchu
expensive	ikspénsiv
hence	jéns
objection	obshékshan
legislation	leshasleishan
pump	pámp
shit	shít
the	de
below	bilou
concrete	kankrít
interfere	interfír
anonymous	anánamas
plain	plein
molecule	málakiul
cease	sís
ring	rín
defensive	difénsiv
story	stóri
hill	jíl
rabbit	rábat
sign	sain
thread	tréd
bishop	bíshop
consideration	konsidereishan
effect	ifékt
approval	aprúval
poke	pouk
charity	chériti
roughly	ráfli
deposit	depózit
fast	fást
visitor	vízater
option	ópshan
locate	loukeit
ratio	reishiou
contemplate	kántampleit
electricity	ilektrísati
global	gloubal
jail	sheil
such	sách
walking	uókin
artistic	artístik
possibility	pasabílati
developing	divélopin
huh	já
accessible	aksésabel
outside	autsaid
circle	serkel
fill	fíl
hunting	jántin
accurate	ákierat
overwhelming	ouveruélmin
maintain	meintein
reduce	radús
socially	soushali
enforce	enfórs
traffic	tráfik
greet	grít
Mrs	mísiz
joke	shouk
preference	préferans
scared	skérd
what	uát
attract	atrákt
climate	klaimat
disability	disabíliti
flavor	fleiver
imagine	imáshan
administer	admínaster
parking	párkin
marker	márker
brown	braun
relationship	rileishanship
course	kórs
sort	sórt
equal	íkual
tremendous	treméndos
prime	praim
secret	síkret
switch	suích
willingness	uílinnes
backyard	bákiard
coin	koin
distract	distrákt
forbid	ferbíd
increased	inkríst
pause	póz
meanwhile	mínuail
burst	berst
replacement	ripleismant
cross	krós
speed	spíd
twin	tuín
hardware	járduer
nevertheless	neverdelés
profound	proufaund
teach	tích
workshop	uerkshop
basic	beisik
dose	dous
initiate	iníshieit
perhaps	perjáps
metaphor	métafor
calm	kám
respect	rispékt
stable	steibel
exclusively	iksklúsivli
unhappy	anjápi
hear	jír
layer	leier
prove	prúv
shallow	shálou
terms	termz
youngster	iónster
bedroom	bédrum
comply	kamplai
drown	draun
fucking	fákin
instrument	ínstrament
analysis	análasas
pickup	píkap
minute	mínat
reward	riuórd
debt	dét
steer	stír
exploit	éksploit
usually	iúshauali
occasional	okeishanal
less	lés
pursuit	persút
shorts	shórts
therapist	térapast
bet	bét
confront	konfrónt
east	íst
gather	gáder
intimate	íntamat
anyway	éniuei
moon	mún
certain	sertan
delivery	dilíveri
stream	strím
failure	feilier
veteran	véteran
historic	jistórik
ongoing	ángouin
line	lain
rail	reil
thus	dás
blank	blánk
Iraqi	iráki
construct	konstrákt
argue	árgiu
pond	pónd
cheer	chír
substance	sábstans
voting	voutin
organizational	organazeishanal
loop	lúp
boil	boil
contract	kóntrakt
elite	ilít
tone	toun
safety	seifti
wash	uásh
assault	asólt
times	taims
jane	shein
drake	dreik
